tkt = t'inquiète pas.
oe = oui
dr = de rien
nn = non
dc = du coup
grv = grave
slt = salut
dsl = désolé
wsh = wesh
frr = frère
js = je sais
jsp = je sais pas
gnt = gênant
mv = ma vie
lv = la vie
vfq = vous faites quoi ?
r = rien
ett = et toi ?
c = c'est
prsn = personne
tt = tout
prv = privé
jpp = je peux pas
mdr = mort de rire
ptdr = pété de rire
pr = pour
pvr = pouvoir
mm = même
qqch = quelque chose
qlq = quelqu'un
pg = pas grave
vla = voilà
lpg = la plus belle
cc = coucou
cv = ça va ?
tg = ta gueule
bjr = bonjour
bsr = bonsoir
dsl = désolé
oklm = au calme
osef = on s'en fout