baka = idiot
afk = déconnecté
askip = a ce qu'il parait
caisse = voiture
bagnole = voiture
baraque = maison
pompes = chaussures
godasses = chaussures
bouffe = nourriture
fric = argent
pognon = argent
oseille = argent
thune = argent
blé = argent
gratte = guitare
fringue = vêtement
clope = cigarette
bouquin = livre
bouquiner = lire
bordel = désordre
frimer = se vanter
branleur = paresseux
bosser = travailler
frangin = frère
frangine = soeur
pote = ami
mec = homme
gars = homme
meuf = femme
gueule = visage
pif = nez
paumer = perdre
fastoche = facile
gonflant = ennuyeux
flipper = avoir peur
cincohe = cinéma
mater = regarder
gourer = tromper
pinard = vin
planque = cachette
piger = comprendre